1111111111111111111
1MMMMMMMMMMMMM100C1
1MMMMMMMMMMMMMM10E1
1MMMMMMMMMMMMMMM1P1
1MMMMMMMMMMMMMMMM11
1MMMMMMMMMMMMMMMMM1
1MMMMMMMMMMMMMMMMM1
1MMMMMMMMMMMMMMMMM1
1MMMMMMMMMMMMMMMMM1
1MMMMMMMMMMMMMMMMM1
1MMMMMMMMMMMMMMMMM1
1MMMMMMMMMMMMMMMMM1
1MMMMMMMMMMMMMMMMM1
1MMMMMMMMMMMMMMMMM1
1MMMMMMMMMMMMMMMMM1
1MMMMMMMMMMMMMMMMM1
1MMMMMMMMMMMMMMMMM1
1MMMMMMMMMMMMMMMMM1
1111111111111111111