1111111111111111111
1MCMCMCMCMCMCM1CCC1
1CMCMCMCMCMCMCM1CE1
1MCMCMCMCMCMCMCM1P1
1CMCMCMCMCMCMCMCM11
1MCMCMCMCMCMCMCMCM1
1CMCMCMCMCMCMCMCMC1
1MCMCMCMCMCMCMCMCM1
1CMCMCMCMCMCMCMCMC1
1MCMCMCMCMCMCMCMCM1
1CMCMCMCMCMCMCMCMC1
1MCMCMCMCMCMCMCMCM1
1CMCMCMCMCMCMCMCMC1
1MCMCMCMCMCMCMCMCM1
1CMCMCMCMCMCMCMCMC1
1MCMCMCMCMCMCMCMCM1
1CMCMCMCMCMCMCMCMC1
1MCMCMCMCMCMCMCMCM1
1111111111111111111