1111111111111111111
1MMM000000MMMMMM001
1111111111111111111
100P0000000000E0C01
1111111111111111111