1111111111111111111
1CCCCCCMCCCECCCCCC1
1111111111111111111
100P0000000000E0001
1111111111111111111