1111111111111111111
1M0M0M0M0M0M0M100C1
10M0M0M0M0M0M0M10E1
1M0M0M0M0M0M0M0M1P1
10M0M0M0M0M0M0M0M11
1M0M0M0M0M0M0M0M0M1
10M0M0M0M0M0M0M0M01
1M0M0M0M0M0M0M0M0M1
10M0M0M0M0M0M0M0M01
1M0M0M0M0M0M0M0M0M1
10M0M0M0M0M0M0M0M01
1M0M0M0M0M0M0M0M0M1
10M0M0M0M0M0M0M0M01
1M0M0M0M0M0M0M0M0M1
10M0M0M0M0M0M0M0M01
1M0M0M0M0M0M0M0M0M1
10M0M0M0M0M0M0M0M01
1M0M0M0M0M0M0M0M0M1
1111111111111111111