1111111111111111111
1M000000000000000M1
1111111111111111111
100P0000000000E0C01
1111111111111111111