1111111111111111111111111111111111111111111111111111111111111111111111111111111111111111111111111111111111111111111
1P00000C00000C00000000000000000000000000000000000000000000000000000000000000000000000000000000000000000000000000001
1000C00000C00000000000000000000000000000000000000000000000000000000000000000000000000000000000000000000000000000E01
1111111111111111111111111111111111111111111111111111111111111111111111111111111111111111111111111111111111111111111