1111111111111111111111111111111111111
1000000000001000000M00000000000000001
10M0111110001000111111111111100011111
10000000100000001000000000001000100E1
1111111110001111111111111000111110001
1000000010000000000000001000000000001
1000100010001111111110001000111110001
1000111111111000000010001000100010001
1P00000000000000100010001000100010001
1111111110001111100010001000100011111
1000000000001000000000001000100000001
1000111110001000100010001000111110001
1000100000001000100010M01000000010001
1000111111111000100011111111100010001
100M10000M001000100000000000000010001
1000111110001000111111111111100010001
1000000000000000000000001000000010001
1111111111111111111111111111111111111