1111111111111111111111
1000C000100000C0000001
1011111010111111101111
10000010001000001010E1
1111111011111110111001
1P0000100000001C000001
1010001011111010111001
1011111110001010101001
1000000000101010101001
1111111011101010101111
1000000010000010100001
1011111010101010111001
1010C0001010101C001001
1011111110101111101001
101000001010000C001001
1011111010111011101001
1000C0000000001C001001
1111111111111111111111