1111111111111111111
1000001000000000001
1011101011111110111
10001000100000101E1
1111101111111011101
1000100000001000001
1010101111101011101
1011111000101010101
1P00000010101010101
1111101110101010111
1000001000001010001
1011101010101011101
1010001010101000101
1011111010111110101
10100M1010000000101
1011101011111110101
1000000000001000101
1111111111111111111