1111111111111111111
1C00001C000M0000001
1011101011111110111
1000100010M0C0101E1
1111101111111011101
10M01000000010000C1
1010101111101011101
1011111000101010101
1P00000010101010101
1111101110101010111
1000001000001010001
1011101010101011101
1C10001010101000101
1011111010111110101
10100M10100M0000111
1M111010111011101M1
1000000000001000111
1111111111111111111