111111111111
1P0000000C01
111110111111
100000000000
100000100E01
111111111111