1111111111111
1EE10000000C1
1000011111001
1P0011E000001
100011000M001
1111111111111