1111111111111
1EE10000000C1
1000011111001
1P0011E000001
100011E00M0C1
1111111111111