1111111111111111111
1CCCCC1CCCCCCCCCCC1
1C111C1C1111111C111
1CCC1CCC1CCCCC1C1E1
11111C1111111C111C1
1CCC1CCCCCCC1CCCCC1
1C1C1C11111C1C111C1
1C11111CCC1C1C1C1C1
1PCCCCCC1C1C1C1C1C1
11111C111C1C1C1C111
1CCCCC1CCCCC1C1CCC1
1C111C1C1C1C1C111C1
1C1CCC1C1C1C1CCC1C1
1C11111C1C11111C1C1
1C1CCC1C1CCCCCCC1M1
1C111C1C111C111C1C1
1CCCCCCCCCCC1CCC1C1
1111111111111111111