111111111111111111111
1M0M0M0MM0101010111P1
111111111110101011101
1111111010101010111C1
1M00001010101010111E1
1111111M1M1M1M1M111E1
111111111111111111111