1111111111111111111
1EEEEE1EEEEEEEEEEE1
1E111E1E1111111E111
1EEE1EEE1EEEEE1E1E1
11111E1111111E111E1
1EEE1EEEEEEE1EEEEE1
1E1E1E11111E1E111E1
1E11111EEE1E1E1E1E1
1PEEEEEE1E1E1E1E1E1
11111E111E1E1E1E111
1EEEEE1EEEEE1E1EEE1
1E111E1E1E1E1E111E1
1E1EEE1E1E1E1EEE1E1
1E11111E1E11111E1E1
1E1EEE1E1EEEEEEE1E1
1E111E1E111E111E1E1
1EEEEEEEEEEE1EEC1E1
1111111111111111111